**********************
****###############***
****#.............#***
****#S.......#....#***
****#........#...s##**
****#.......S#.....#**
****################**
**********************
