*********************
****###############**
****#.............#**
****#........#....#**
****#........#....#**
****###############**
*********************
